111111111111111111111111111111
1CCCCCCCCC10000000000000000001
1C1111111C1C111100000000000001
1C1111111C?C111000000000000001
1C1111111C1C111000000000000001
1C1111111C00000000000000000001
1C1111111C1C111111110000000001
1C1111111C?C111111110000000001
1C1111111C1C111111110000000001
1PCCCCCCCC1CCCCCCCC?1111111?E1
111111111111111111111111111111