111111111111111111111111111111
1CCCCCCCCC1CCCCCCCCCCCCCCCCCC1
1C1111111C1C111C111C11111C11C1
1C1111111C?C111C111C11111C11C1
1C1111111C1C111C111C11111C?CC1
1C1111111CCCCCC?CCCC11111?11C1
1C1111111C1C1111111C1111100001
1C1111111C?C1111111C1111100001
1C1111111C1C1111111C1111100001
1PCCCCCCCC1CCCCCCC?CCCCC?000E1
111111111111111111111111111111