111111111111111111111111
1P00C0000000000000000001
101111011111000001111101
1000000C0000011110000001
101111E11111000001111101
111111111111111111111111