111111111111111111111111
1P11C0000000000000000101
101100011111000001111101
1000000C0000011110000001
101111E11111000001111101
111111111111111111111111