1111111111111111111111111111111111
1P00C0000000000000000000000C000001
1011110111110000011111011110111101
1000000C00000111100000000000000001
1011110111110000011111011110E00C01
1111111111111111111111111111111111