111111111111111111111111
1P11C0000000000000000111
101100011111000001110111
1000000C0000?11110000111
111111E11111000001110111
111111111111111111111111