111111111111111111111111
1P11C0000000000000000001
101100011111000001110101
1000000C0000011110000101
101111E11111000001110101
100000000000000000000001
111111111111111111111111