111111111111111111111111111111
1P0000000C00000C00000000000E01
101110101001000000000101010101
101110000000010101000000000001
101110100100000C00000101010101
100000000000010101000000000001
101010100100000000000101010101
100000000C00010101000000000001
101010100100000000000101010101
100000000000010101000000000C01
101010100100000000000101010101
100000000000010101000000000001
101010100100000C00000101010101
100C00000000010101000000000001
100000000000000000000000000001
111111111111111111111111111111