1111111
1P00X01
1C00E01
1111111