1111111
1P00E01
1C00E01
1111111