1111111
1P00P01
1C00001
1111111