1111111
1000001
1C00P01
1111111