1111111
1000001
1C00E01
1111111