1111111111
1P00000001
1111111111
1C00000001
1111111101
1E00000001
1111111111
