1111111
1P0001
1C00E01
1111111