1111111
0P00001
1C00E01
1111111