1111111111111111111111111111111
1P000000000000000000000000000C1
1010101010010000000001010101011
1000000000000101010000000000001
1010101001000000000001010101011
1000000000000101010000000000001
1010101001000000000001010101011
1000000000000101010000000000001
1010101001000000000001010101011
1000000000000101010000000000C01
1010101001000000000001010101011
1000000000000101010000000000001
1010101001000000000001010101011
10C0000000000101010000000000001
1000000000000000000000000000001
1000000000000000000000000000E01
1111111111111111111111111111111