1111111111111111111111
1P000000000000000C0011
1011110111110111110C11
1C00000C00000C00000C11
1011110111110111110C11
1C00000C00000C00000C11
1011110111110111110C11
1C00000C00000C00000C11
1011110111110111110C11
1C00000000000000000E11
1111111111111111111111
