1111111111111111111111
1P000000000000000C0001
1011110111110111110C01
1C00?00C00?00C00000C01
1011110111110111110C01
1C00000C00000C00?00C01
1011110111110111110C01
1C00?00C00000C00000C01
1011110111110111110C01
1C00000000?00000000E01
1111111111111111111111
