11111111111111111111111
1P000C00000C00000C001
1011111011110111110C1
1C00000C00000C00000C1
1011111011110111110C1
1C00000C00000C00000C1
1011111011110111110C1
1C00000C00000C00000C1
1011111011110111110C1
1000C00000000C00000E1
11111111111111111111111
