11111111111111111111111111
1P0000C0000C0000C000001
100011111001111100111C1
1C0?00000C?0000C?00001
101111100111110011111C1
1C0000C00000C0000C0001
101111100111110011111C1
1C0?00000C?0000C?00001
101111100111110011111C1
1000C0000000C00000000E1
11111111111111111111111
