111111111111111111111111
1P0000C00000C0000C001
101111101111011111101
1C0000C00000C0000C001
101111101111011111101
1C0000C00000C0000C001
101111101111011111101
1C0000C00000C0000C001
101111101111011111101
1C0000C00000C000000E1
111111111111111111111
