1111111111111111111111111
1P00000C0000C0000C0001
1011111011110111110101
1C00?00C00000C00?00C1
1011111011110111110101
1C00000C0000?C00000C1
1011111011110111110101
1C00?00C00000C00?00C1
1011111011110111110101
1C00000C00000C00000E1
1111111111111111111111
